{
  "size": { "x": 7, "y": 7 },
  "timeLimit": 180,
  "name": "",
  "arrows": {
    "0": {
      "nodes": {
        "0": { "x": 0, "y": 0 },
        "1": { "x": 0, "y": 1 },
        "2": { "x": 0, "y": 2 },
        "3": { "x": 0, "y": 3 },
        "4": { "x": 0, "y": 4 },
        "5": { "x": 0, "y": 5 },
        "6": { "x": 0, "y": 6 }
      },
      "color": 3
    },
    "1": {
      "nodes": {
        "0": { "x": 6, "y": 6 },
        "1": { "x": 5, "y": 6 },
        "2": { "x": 4, "y": 6 },
        "3": { "x": 3, "y": 6 },
        "4": { "x": 2, "y": 6 },
        "5": { "x": 1, "y": 6 },
        "6": { "x": 1, "y": 5 },
        "7": { "x": 2, "y": 5 },
        "8": { "x": 3, "y": 5 },
        "9": { "x": 4, "y": 5 },
        "10": { "x": 5, "y": 5 }
      },
      "color": 4
    },
    "2": {
      "nodes": {
        "0": { "x": 4, "y": 3 },
        "1": { "x": 3, "y": 3 },
        "2": { "x": 2, "y": 3 },
        "3": { "x": 2, "y": 2 }
      },
      "color": 4
    },
    "3": {
      "nodes": {
        "0": { "x": 5, "y": 1 },
        "1": { "x": 4, "y": 1 },
        "2": { "x": 4, "y": 2 }
      },
      "color": 3
    },
    "4": {
      "nodes": {
        "0": { "x": 3, "y": 2 },
        "1": { "x": 3, "y": 1 },
        "2": { "x": 2, "y": 1 }
      },
      "color": 1
    },
    "5": {
      "nodes": {
        "0": { "x": 3, "y": 0 },
        "1": { "x": 2, "y": 0 },
        "2": { "x": 1, "y": 0 },
        "3": { "x": 1, "y": 1 },
        "4": { "x": 1, "y": 2 },
        "5": { "x": 1, "y": 3 },
        "6": { "x": 1, "y": 4 },
        "7": { "x": 2, "y": 4 },
        "8": { "x": 3, "y": 4 },
        "9": { "x": 4, "y": 4 },
        "10": { "x": 5, "y": 4 },
        "11": { "x": 5, "y": 3 },
        "12": { "x": 5, "y": 2 }
      },
      "color": 2
    },
    "6": {
      "nodes": {
        "0": { "x": 6, "y": 5 },
        "1": { "x": 6, "y": 4 },
        "2": { "x": 6, "y": 3 },
        "3": { "x": 6, "y": 2 },
        "4": { "x": 6, "y": 1 },
        "5": { "x": 6, "y": 0 },
        "6": { "x": 5, "y": 0 },
        "7": { "x": 4, "y": 0 }
      },
      "color": 0
    }
  },
  "wayBlockers": {},
  "blackHoles": {},
  "portals": {}
}