{
  "size": { "x": 9, "y": 9 },
  "timeLimit": 180,
  "arrows": {
    "0": {
      "nodes": {
        "0": { "x": 8, "y": 8 },
        "1": { "x": 8, "y": 7 },
        "2": { "x": 8, "y": 6 },
        "3": { "x": 8, "y": 5 },
        "4": { "x": 8, "y": 4 },
        "5": { "x": 8, "y": 3 },
        "6": { "x": 8, "y": 2 },
        "7": { "x": 8, "y": 1 },
        "8": { "x": 8, "y": 0 },
        "9": { "x": 7, "y": 0 }
      },
      "color": 2
    },
    "1": {
      "nodes": {
        "0": { "x": 0, "y": 8 },
        "1": { "x": 0, "y": 7 },
        "2": { "x": 0, "y": 6 },
        "3": { "x": 0, "y": 5 },
        "4": { "x": 0, "y": 4 },
        "5": { "x": 0, "y": 3 },
        "6": { "x": 0, "y": 2 },
        "7": { "x": 0, "y": 1 },
        "8": { "x": 0, "y": 0 },
        "9": { "x": 1, "y": 0 },
        "10": { "x": 2, "y": 0 },
        "11": { "x": 3, "y": 0 },
        "12": { "x": 4, "y": 0 },
        "13": { "x": 5, "y": 0 },
        "14": { "x": 6, "y": 0 },
        "15": { "x": 6, "y": 1 },
        "16": { "x": 5, "y": 1 },
        "17": { "x": 4, "y": 1 }
      },
      "color": 4
    },
    "2": {
      "nodes": {
        "0": { "x": 1, "y": 1 },
        "1": { "x": 2, "y": 1 }
      },
      "color": 1
    },
    "3": {
      "nodes": {
        "0": { "x": 1, "y": 8 },
        "1": { "x": 2, "y": 8 },
        "2": { "x": 2, "y": 7 },
        "3": { "x": 1, "y": 7 },
        "4": { "x": 1, "y": 6 }
      },
      "color": 3
    },
    "4": {
      "nodes": {
        "0": { "x": 5, "y": 8 },
        "1": { "x": 6, "y": 8 },
        "2": { "x": 7, "y": 8 },
        "3": { "x": 7, "y": 7 },
        "4": { "x": 7, "y": 6 },
        "5": { "x": 7, "y": 5 },
        "6": { "x": 7, "y": 4 },
        "7": { "x": 7, "y": 3 },
        "8": { "x": 6, "y": 3 },
        "9": { "x": 5, "y": 3 },
        "10": { "x": 5, "y": 4 },
        "11": { "x": 5, "y": 5 },
        "12": { "x": 4, "y": 5 }
      },
      "color": 3
    },
    "5": {
      "nodes": {
        "0": { "x": 5, "y": 7 },
        "1": { "x": 6, "y": 7 },
        "2": { "x": 6, "y": 6 },
        "3": { "x": 6, "y": 5 },
        "4": { "x": 6, "y": 4 }
      },
      "color": 1
    },
    "6": {
      "nodes": {
        "0": { "x": 2, "y": 3 },
        "1": { "x": 2, "y": 4 },
        "2": { "x": 2, "y": 5 },
        "3": { "x": 2, "y": 6 },
        "4": { "x": 3, "y": 6 },
        "5": { "x": 3, "y": 7 },
        "6": { "x": 3, "y": 8 },
        "7": { "x": 4, "y": 8 },
        "8": { "x": 4, "y": 7 },
        "9": { "x": 4, "y": 6 },
        "10": { "x": 5, "y": 6 }
      },
      "color": 4
    },
    "7": {
      "nodes": {
        "0": { "x": 4, "y": 4 },
        "1": { "x": 4, "y": 3 },
        "2": { "x": 3, "y": 3 },
        "3": { "x": 3, "y": 4 },
        "4": { "x": 3, "y": 5 }
      },
      "color": 2
    },
    "8": {
      "nodes": {
        "0": { "x": 4, "y": 2 },
        "1": { "x": 5, "y": 2 },
        "2": { "x": 6, "y": 2 },
        "3": { "x": 7, "y": 2 },
        "4": { "x": 7, "y": 1 }
      },
      "color": 1
    },
    "9": {
      "nodes": {
        "0": { "x": 3, "y": 1 },
        "1": { "x": 3, "y": 2 },
        "2": { "x": 2, "y": 2 },
        "3": { "x": 1, "y": 2 },
        "4": { "x": 1, "y": 3 },
        "5": { "x": 1, "y": 4 },
        "6": { "x": 1, "y": 5 }
      },
      "color": 3
    }
  },
  "wayBlockers": {},
  "blackHoles": {},
  "portals": {}
}